Afghanistan:	Stray Dogs
Albania:	Change
Algeria:	The Harem of Madame Osmane
American Samoa:	Seki A Oe A Crazy Samoan Love Story
Andorra:	The Burning Cold
Angola:	Liberdade
Anguilla:	Our Anguilla
Antarctica:	Lilliput in Antarctica
Antigua and Barbuda:	Hooked
Argentina:	Piazzolla The Years of the Shark
Armenia:	Lost in Armenia
Aruba:	Unstoppable
Australia:	Late Night with the Devil
Austria:	Harodim
Azerbaijan:	Cold as Marble
Bahamas:	Love at Sea
Bahrain:	One Day on Earth
Bangladesh:	The Salt in Our Waters
Barbados:	Into the Darkness
Belarus:	Ivan  Abraham
Belgium:	Golden Youth
Belize:	Yai Wanonabalewa The Enemy God
Benin:	Arlit The Second Paris
Bermuda:	By Any Means
Bhutan:	Travellers and Magicians
Bolivia:	Maleficarum
Bosnia and Herzegovina:	Our Everyday Life
Botswana:	The Last Lions
Brazil:	Power Alley
British Indian Ocean Territory:	The Last Maneater Killer Tigers of India
British Virgin Islands:	Virgin Island
Brunei Darussalam:	Echoes from the Minaret
Bulgaria:	The Lark Farm
Burkina Faso:	Samba Traor
Burundi:	A Colorful life
Cambodia:	Cher  the Loneliest Elephant
Cameroon:	The Great White of Lambarene
Canada:	A Gift of Miracles
Cape Verde:	Napomucenos Will
Cayman Islands:	Exploring Bloody Bay Wall
Central African Republic:	Song from the Forest
Chad:	Hissein Habr A Chadian Tragedy
Chile:	The Year of the Everlasting Storm
China:	Bounty Hunters
Colombia:	Everybody Leaves
Comoros:	Ylang Ylang Residence
Congo:	Lumumba Death of a Prophet
Cook Islands:	Kia Orana
Costa Rica:	Leaves of K
Cote D'Ivoire:	Aya of Yop City
Croatia:	Fury of the Demon
Cuba:	Santa  Andres
Cyprus:	The Man with the Answers
Czech Republic:	Fair Play
Czechoslovakia:	Tich Amerian v Praze
Denmark:	Dalecarlians
Djibouti:	One Day on Earth
Dominica:	Uncivilized
Dominican Republic:	El fantasma de mi novia
East Germany:	In the Dust of the Stars
Ecuador:	Camino a la libertad
Egypt:	Sawah
El Salvador:	Wild El Salvador In the Shadow of the Volcanoes
Equatorial Guinea:	El Limpiabotas
Eritrea:	Minister
Estonia:	The Singing Revolution
Ethiopia:	A Walk to Beautiful
Faeroe Islands:	Bye Bye Blue Bird
Falkland Islands:	Fuckland
Fiji:	Kumu Hina
Finland:	Beauty and the Bastard
France:	Idiot in Paris
French Guiana:	Beautiful
French Polynesia:	Savages The Story of Human Zoos
Gabon:	The Rhythm of My Life Ismael Sankara
Gambia:	One Day on Earth
Georgia:	Wet Sand
Germany:	White Hell of Pitz Palu
Ghana:	The Burial of Kojo
Gibraltar:	Alexander Povetkin vs Dillian Whyte II
Greece:	Strella
Greenland:	Heart of Light
Grenada:	Grenada Confronting the Past
Guadaloupe:	La Soufrire
Guam:	Shiros Head
Guatemala:	Creedacio I
Guinea-Bissau:	One Day on Earth
Guinea:	The African Child
Guyana:	The Terror and the Time
Haiti:	Cristo Rey
Holy See:	Bells of Europe
Honduras:	Utopia The Scattered Body and the World Upside Down
Hong Kong:	Shaolin Popey
Hungary:	Germinal
Iceland:	Last and First Men
India:	Punyalan Private Limited
Indonesia:	Sacred 2
Iran:	Fish  Cat
Iraq:	Haifa Street
Ireland:	Road
Israel:	Warriors
Italy:	Lady Football
Jamaica:	Life and Debt
Japan:	Kamen Rider Blade Missing Ace
Jordan:	When I Saw You
Kazakhstan:	A Friend of the Deceased
Kenya:	When Lambs Become Lions
Kiribati:	Kiribati The Presidents Dilemma
Kosovo:	Her
Kuwait:	Our River Our Sky
Kyrgyz Republic:	One Day on Earth
Lao People's Democratic Republic:	At the Horizon
Latvia:	Dream Team 1935
Lebanon:	Where To
Lesotho:	Weekend at Mafeteng
Liberia:	Murder in the Cassava Patch
Libyan Arab Jamahiriya:	The Message
Liechtenstein:	Eugenie
Lithuania:	Summer Survivors
Luxembourg:	The Kings of the World
Macao:	Return To Earth
Macedonia:	The Liberation of Skopje
Madagascar:	Tabataba
Malawi:	One Day on Earth
Malaysia:	Kami Histeria
Maldives:	Nina
Mali:	The Young Girl
Malta:	Torpedo U235
Marshall Islands:	The Sound of Crickets at Night
Martinique:	Battledream Chronicle
Mauritania:	The Black Wogs Your Neighbors
Mauritius:	Benares
Mayotte:	Haroussi
Mexico:	The Three Musketeers
Micronesia:	Papa Mau
Moldova:	What a Wonderful World
Monaco:	Eye in the Labyrinth
Mongolia:	Khadak
Montenegro:	Diamond of Boyana
Montserrat:	Montserrat Emerald of the Caribbean
Morocco:	The Blue Panther
Mozambique:	Plot for Peace
Myanmar:	Myanmar Diaries
Namibia:	Namibia The Struggle for Liberation
Nepal:	Pashupati Prasad
Netherlands Antilles:	Sharks Treasure
Netherlands:	Amsterdam
New Caledonia:	Awesome Runaway
New Zealand:	Sleeping Dogs
Nicaragua:	Alsino and the Condor
Niger:	Arlit The Second Paris
Nigeria:	ABCs of Death 2
Niue:	Niue This Is Your Land
North Korea:	NJPW  WCW Collision In Korea
Northern Ireland:	Bloodshed
Northern Mariana Islands:	My Haggan Dream
Norway:	Beck 35  Your Own Blood
Oman:	The Nose  Searching for Blamage
Pakistan:	Saawan
Palau:	The Last Reef Cities Beneath the Sea
Palestinian Territory:	Giraffada
Panama:	Oasis
Papua New Guinea:	Dead Birds
Paraguay:	Paraguay Drugs and Banana
Peru:	The Nutcracker Sweet
Philippines:	Child of Sorrow
Poland:	The Wedding
Portugal:	Hovering Over the Water
Puerto Rico:	Tarzan in the Golden Grotto
Qatar:	Wajib
Reunion:	Opposites
Romania:	Method
Russia:	Zoya
Rwanda:	Africa United
Samoa:	The Pursuit
San Marino:	The Tail
Sao Tome and Principe:	Sea and the Jungle
Saudi Arabia:	WWE Crown Jewel 2021
Senegal:	Atlantiques
Serbia and Montenegro:	Midwinter Nights Dream
Serbia:	Darkling
Seychelles:	Bolot Feray
Sierra Leone:	Shout Gladi Gladi
Singapore:	Bugis Street
Slovakia:	Svtci zo Skalky
Slovenia:	Thanks for Sunderland
Solomon Islands:	PT 109
Somalia:	Pirates Threatening Global Trade
South Africa:	WahWah
South Korea:	The Show Must Go On
South Sudan:	Jamila
Soviet Union:	Rudolfio
Spain:	Seven Guns for the MacGregors
Sri Lanka:	Sri Siddhartha Gautama
St. Helena:	Tristan da Cunha No Place Like Home
St. Kitts and Nevis:	A Rose Between Thorns
St. Lucia:	21 Days
St. Pierre and Miquelon:	Making Love in St Pierre
St. Vincent and the Grenadines:	The Seagull
Sudan:	We Are the Ones
Suriname:	Bolletjes Blues
Svalbard & Jan Mayen Islands:	Project Iceman
Swaziland:	Liyana
Sweden:	HalloHallo
Switzerland:	Golden Years
Syrian Arab Republic:	Gulstan Land of Roses
Taiwan:	Godspeed
Tajikistan:	True Noon
Tanzania:	EONII
Thailand:	This Girl Is Bad Ass
Timor-Leste:	One Day on Earth
Togo:	Togo le foot et la politique ne font quun
Tonga:	When the Man Went South
Trinidad and Tobago:	The Whisper of the Leaves
Tunisia:	As I Open My Eyes
Turkey:	Beyond the Hill
Turkmenistan:	Little Angel Make Me Happy
Turks and Caicos Islands:	Chupacabra Terror
Tuvalu:	Islet
US Virgin Islands:	The Adventures of Fiyah Dog
Uganda:	The Girl in the Yellow Jumper
Ukraine:	The Saratov Approach
United Arab Emirates:	The Ones Below
United Kingdom:	The Curse of Robert the Doll
United States of America:	Spellbound
Uruguay:	A Monster with a Thousand Heads
Uzbekistan:	One Day on Earth
Vanuatu:	Let Us Persevere in What We Have Resolved Before We Forget
Venezuela:	Glue Sniffer
Vietnam:	Head Rush
Yemen:	One Day on Earth
Yugoslavia:	Miss
Zaire:	Life Is Rosy
Zambia:	Doin My Drugs
Zimbabwe:	House of Children
